12 12 12 12 12 12 12 12 12 12 12 12 12 12 12 12 12 12 12 12 12 12 12 12 12 12 12 12 12 12 12 12 12 12 12 12 12 12 12 12 12 12 12 12 12 12 12 12 12 12 
12 12 12 12 12 12 12 12 12 12 12 12 12 12 13 12 12 12 12 12 12 12 12 12 12 12 12 12 12 12 12 12 12 12 12 12 12 12 12 12 12 12 12 12 12 12 12 12 12 12 
12 12 12 12 12 12 12 13 12 12 12 12 12 12 12 12 12 12 12 12 12 12 12 12 12 13 12 12 12 12 12 12 12 13 12 12 12 12 12 12 12 12 12 12 12 12 12 12 12 12 
12 12 12 12 13 12 12 12 12 12 12 13 12 12 12 12 12 12 13 12 12 12 12 12 12 12 12 13 12 12 12 12 12 12 12 12 12 12 12 12 12 13 12 12 12 12 12 12 12 12  
12 12 12 12 12 12 12 12 12 13 12 12 12 12 12 13 12 12 12 12 12 12 12 13 12 12 12 12 12 12 12 13 12 12 13 12 12 12 13 12 12 12 12 12 12 12 12 12 12 12 
12 12 12 12 12 12 12 12 12 12 12 12 12 12 12 12 12 12 12 12 12 13 12 12 12 12 12 12 12 13 12 12 12 12 12 12 13 12 12 12 12 12 12 13 12 12 12 12 12 12  
12 12 12 12 12 13 22 20 20 20 20 20 20 20 23 12 12 12 22 20 20 20 20 20 20 20 20 23 12 12 12 22 20 20 20 20 20 23 22 20 20 20 23 12 12 12 12 12 12 12 
12 12 12 12 12 12 18 41 41 10 10 11 11 11 19 20 20 20 21 41 35 33 33 33 33 33 36 19 20 20 20 21 41 11 11 10 10 17 18 11 10 10 17 12 12 13 12 12 12 12 
12 12 13 12 12 12 18 41 41 10 41 41 10 41 41 41 41 41 41 41 31 26 26 26 26 26 30 41 41 41 41 41 41 41 10 14 15 25 24 15 16 10 17 12 12 12 12 12 12 12
12 12 12 12 12 12 18 41 11 11 10 41 10 41 41 41 41 41 41 41 31 26 27 28 29 26 30 41 41 41 41 41 41 41 10 17 12 12 12 12 18 10 17 12 12 12 12 12 12 12 
12 12 12 13 12 12 18 41 11 41 41 41 11 11 11 10 11 41 41 41 31 26 32 33 34 26 30 41 41 57 42 42 54 55 10 17 12 12 12 12 18 10 17 12 13 12 12 12 12 12 
12 12 12 12 13 12 18 41 10 10 10 41 10 41 41 10 41 41 10 11 31 26 26 26 26 26 30 41 41 44 59 56 41 41 10 19 20 20 20 20 21 10 17 12 12 12 12 12 12 12 
12 12 12 12 12 12 18 41 41 10 11 10 10 41 41 10 41 41 10 41 37 28 29 26 27 28 38 41 41 44 45 41 41 41 10 10 10 10 11 10 10 10 17 13 12 12 12 12 12 12 
12 12 12 12 12 12 18 41 41 41 10 41 41 41 41 10 41 41 10 41 41 41 31 26 30 41 41 41 41 44 45 41 41 41 41 41 41 41 41 41 14 15 25 12 12 12 12 12 12 12 
12 12 12 12 13 12 18 41 41 41 10 41 41 41 41 10 10 11 10 41 41 41 31 26 30 41 41 41 41 44 45 41 41 41 41 41 41 41 41 41 17 12 12 12 12 13 12 12 12 12 
12 12 12 12 12 12 24 15 16 41 10 41 41 41 41 41 41 11 41 41 41 41 31 26 47 42 42 42 42 58 45 41 41 41 41 41 41 35 33 36 17 12 12 12 12 12 12 12 12 12 
12 12 12 12 12 12 12 12 18 41 10 41 41 41 41 41 41 10 41 41 41 41 31 26 46 43 43 43 43 43 56 41 41 41 41 41 41 31 26 30 17 12 12 12 12 12 13 12 12 12 
12 12 13 12 12 12 12 22 21 41 11 41 41 41 41 41 41 10 41 41 41 41 31 26 30 41 41 41 41 41 41 41 41 41 41 35 33 34 26 30 17 12 12 13 12 12 12 12 12 12 
12 12 12 12 12 12 22 21 10 10 10 41 41 41 41 41 41 11 41 41 41 41 31 26 30 41 41 41 41 41 41 41 41 41 41 31 26 26 26 30 17 12 12 12 12 12 12 12 12 12 
12 12 12 13 12 12 18 41 10 10 41 41 41 41 41 41 41 10 41 41 41 10 31 26 30 10 41 41 41 41 41 41 41 41 41 31 26 27 28 38 17 12 13 12 12 12 12 12 12 12 
12 12 12 12 12 12 18 41 10 11 41 41 10 35 33 33 33 33 33 33 33 33 34 26 32 33 33 33 33 33 33 33 33 33 33 34 26 30 41 41 17 12 12 12 12 12 12 12 12 12 
12 12 12 12 12 13 18 41 10 10 41 41 11 31 26 26 26 26 26 26 26 26 26 26 26 26 26 26 26 26 26 26 26 26 26 26 26 30 41 14 25 12 12 12 12 12 12 12 12 12 
12 12 12 12 12 12 24 16 10 10 41 41 10 37 28 28 28 28 28 28 28 28 29 26 27 28 28 28 28 28 28 28 28 28 28 29 26 30 10 17 12 13 12 12 12 12 12 12 12 12 
12 12 12 12 12 12 12 24 16 11 41 41 10 10 41 41 41 41 41 41 41 10 31 26 30 10 41 41 41 41 41 41 41 41 41 31 26 30 10 17 12 12 12 12 13 12 12 12 12 12 
12 12 12 12 12 12 12 12 18 10 41 41 10 11 41 41 41 41 41 41 41 41 31 26 30 41 41 41 41 41 41 41 41 41 41 31 26 30 11 17 12 12 12 12 12 12 12 12 12 12 
12 12 12 12 12 13 12 22 21 10 41 41 10 10 10 41 41 41 41 41 41 41 31 26 30 41 41 41 41 41 41 41 41 41 41 31 26 30 10 17 12 12 12 13 12 12 12 12 12 12 
12 12 12 12 12 12 12 18 10 10 41 41 41 41 10 41 41 41 41 41 41 41 31 26 30 41 41 41 41 41 41 41 41 41 41 31 26 30 10 17 12 12 12 12 12 12 12 12 12 12 
12 12 12 13 12 12 12 18 11 41 41 41 41 41 10 41 41 41 41 41 41 41 31 26 30 41 41 10 41 41 41 41 41 41 41 31 26 30 10 17 12 13 12 12 12 12 12 12 12 12 
12 12 12 12 12 12 12 18 10 41 41 41 41 41 10 41 41 41 41 41 41 41 31 26 30 41 41 41 41 41 41 41 41 41 41 31 26 30 10 17 12 12 12 12 12 12 12 12 12 12 
12 12 12 12 12 12 13 18 10 10 10 10 10 10 10 41 14 15 15 16 41 41 31 26 30 41 41 41 41 41 41 41 41 41 41 37 28 38 10 17 12 12 12 12 13 12 12 12 12 12 
12 12 12 12 12 12 12 18 10 10 11 10 10 10 10 41 17 12 12 18 41 41 31 26 30 41 41 41 41 41 41 41 41 41 41 11 10 10 14 25 12 12 13 12 12 12 12 12 12 12 
12 12 12 12 12 12 12 24 16 10 10 10 10 10 10 41 19 20 20 21 41 41 31 26 30 41 41 41 41 10 41 41 41 41 41 10 10 10 17 12 12 12 12 12 12 12 12 12 12 12 
12 12 12 12 12 13 12 12 18 10 10 10 10 11 10 41 41 41 41 41 41 41 31 26 30 41 41 41 41 10 41 41 41 41 41 10 10 10 17 12 12 12 12 12 12 12 13 12 12 12 
12 12 12 12 12 12 12 12 18 11 10 10 10 10 10 41 41 41 41 41 41 41 31 26 30 41 41 41 41 41 41 41 41 41 41 10 10 11 17 12 12 13 12 12 12 12 12 12 12 12 
12 12 12 12 12 12 12 22 21 10 41 41 41 41 41 41 41 41 41 41 41 41 31 26 30 41 41 41 41 41 41 41 41 41 41 10 10 10 17 12 12 12 12 12 12 12 12 12 12 12 
12 12 12 12 13 12 12 18 41 10 41 41 41 41 41 41 41 41 41 41 41 41 37 28 38 41 41 41 41 41 41 41 41 41 41 11 10 10 19 23 12 12 12 12 12 12 12 12 12 12 
12 12 12 12 12 12 12 18 41 10 41 41 11 11 11 11 41 41 41 10 10 10 10 10 10 10 10 41 41 41 41 41 41 41 10 10 10 10 10 19 23 12 12 12 13 12 12 12 12 12 
12 12 12 12 12 12 13 18 41 10 11 11 11 41 41 11 41 41 10 10 41 41 10 10 10 41 10 10 41 41 11 41 41 10 10 10 10 10 10 10 17 12 12 12 12 12 12 12 12 12 
12 12 12 12 12 12 12 18 10 10 41 41 11 11 41 41 41 41 10 11 10 10 11 10 10 11 10 10 41 41 41 41 41 40 40 40 39 40 40 40 17 12 13 12 12 12 12 12 12 12 
12 12 12 12 12 12 12 18 11 10 41 41 41 41 41 41 41 41 10 10 11 10 10 10 10 41 10 10 10 41 41 41 41 40 39 39 39 39 39 40 17 12 12 12 12 12 12 12 12 12 
12 12 13 12 12 12 12 18 10 10 41 41 41 41 10 10 10 10 10 10 41 10 10 41 10 10 10 10 14 16 10 10 11 40 39 39 39 39 39 40 17 12 12 12 12 13 12 12 12 12 
12 12 12 12 12 12 12 18 41 10 41 41 10 10 10 14 15 15 16 10 10 10 10 10 11 10 10 14 25 24 16 10 10 40 39 39 39 39 39 40 17 12 12 12 12 12 12 13 12 12 
12 12 12 12 12 12 12 18 41 10 10 10 10 11 14 25 12 12 24 16 10 41 10 10 10 10 14 25 12 12 18 41 10 40 39 39 39 39 39 40 17 12 12 12 12 12 12 12 12 12 
12 12 12 12 13 12 12 24 15 15 15 15 15 15 25 12 12 12 12 24 15 15 15 15 15 15 25 12 13 12 24 16 41 40 40 40 40 40 40 40 17 12 12 13 12 12 12 12 12 12 12 
12 12 12 12 12 12 12 12 12 12 12 12 12 12 12 12 12 12 13 12 12 12 12 12 12 12 12 12 12 12 12 24 15 15 15 15 15 15 15 15 25 12 12 12 12 12 13 12 12 12 
12 12 12 12 12 12 12 12 12 12 12 13 12 12 12 12 13 12 12 12 12 12 12 12 12 12 12 12 12 12 12 12 12 12 12 12 13 12 12 12 12 12 12 13 12 12 12 12 12 12 
12 12 12 12 12 12 13 12 12 12 12 12 12 12 12 12 12 12 12 12 12 12 12 12 13 12 12 12 12 13 12 12 12 12 12 12 12 12 12 12 12 12 12 12 12 12 12 12 12 12 
12 12 12 12 12 12 12 12 12 12 12 12 12 12 13 12 12 12 12 12 13 12 12 12 12 12 12 12 12 12 12 12 13 12 12 12 12 12 12 13 12 12 12 12 12 12 12 12 12 12 
12 12 12 12 12 12 12 12 12 12 12 12 12 12 12 12 12 12 12 12 12 12 12 12 12 12 12 13 12 12 12 12 12 12 12 12 12 12 12 12 12 12 12 12 12 13 12 12 12 12 
12 12 12 12 12 12 12 12 12 12 12 12 12 12 12 12 12 12 12 12 12 12 12 12 12 12 12 12 12 12 12 12 12 12 12 12 12 12 12 12 12 12 12 12 12 12 12 12 12 12 